000000000000000000000000000000000000000000000000000000000000000
0                            0     0   00000   0   0          0
0                             0   0    0   0   0   0          0
0                              0 0     0   0   0   0          0
0A                              0      0   0   0   0          0
0                               0      0   0   0   0          0
0                               0      00000   00000          0
0         00000000000000000000000000000000000000000000000000000
0                                                             0
000000000000000000000000000000000000000000000000000000000000000
                                                              0
                     0                0   0000000    00     0 0
                      0              0       0       0 0    0 0
                       0     00     0        0       0  0   0 0
                        0   0  0   0         0       0   0  0 0
                         0 0    0 0          0       0    0 0 0
                          0      0        0000000    0     00 0
000000000000000000000000000000000000000000000000000000000000000