0000000000000000000000000000000000000000000000000000000000000000
0         D 0*                                                 0
0     0000000  00    00   00      ^                            0
0              00^  ^00 ^ 00A    00                            0
0     00000000000000000000000000000000000000000000000000000    0
0     0                                                        0
0    0                                        00000000000000   0
0000000                                      0                 0
0                 000000000000000000000000000                  0
0                0                                             0
0               0                                              0
0              0                                               0
0             0                                                0
0            0                                                 0
0           0                                                  0
0          0           K                                       0
0         0            0000                                    0
0        0                                                     0
0       0                   0000                               0
0      0                                                       0
0     0                         0000                           0
0    0                                                         0
0   0                                 0000                     0
0                                                              0
0                                                           ^^^0
0000000000000000000000000000000000000000000000000000000000000000