0000000000000000000000000000000000000000
0000000000000000000++++++++            0
0      0000000000000                   0
0      000000000000 0                  0
0      000000000000  0                 0
0                     0                0
0                      0               0
0                 0 Abb 0              0
0                 0                    0
0               000                    0
0                 0Abbbbbbb  0         0
0             00000----------0         0
0000000RRRRR0000000000000000000000000000
0                                      0
0                                      0
0                                      0
0                                      0
0                                      0
0                                      0
0                                      0
0                                      0
0                                      0
0                                      0
0                                      0
0000000000000000000000000000000000000000